19 100
5 5 5 5 5 5 5 5 5 5 5 5 5 5 5 5 5 5 5 5 5 5 5 5 5 5 5 5 5 5 5 5 5 5 5 5 5 5 5 5 5 5 5 5 5 5 5 5 5 5 5 5 5 5 5 5 5 5 5 5 5 5 5 5 5 5 5 5 5 5 5 5 5 5 5 5 5 5 5 5 5 5 5 5 5 5 5 5 5 5 5 5 5 5 5 5 5 5 5 5 
5 0 0 0 0 0 0 0 0 0 0 0 0 0 0 0 0 0 0 0 3 6 0 5 0 0 0 0 0 0 0 0 0 5 0 0 0 0 0 0 0 0 0 0 0 0 0 0 0 3 0 6 0 0 0 0 3 0 0 0 0 0 0 3 0 0 0 0 0 0 0 3 0 0 0 6 0 0 0 0 0 3 0 0 0 0 0 0 0 0 3 0 0 0 0 0 0 0 6 5 
5 0 0 0 0 0 0 0 0 5 7 0 0 0 0 0 0 0 0 4 4 4 0 5 0 0 0 0 0 0 0 0 0 5 0 0 0 0 0 0 0 0 0 0 6 0 0 0 4 4 4 4 4 4 4 4 4 4 4 4 4 4 4 4 4 4 4 4 4 4 4 4 4 4 4 4 4 2 2 2 4 4 4 4 4 4 4 4 4 4 4 4 4 4 4 4 4 4 7 5 
5 0 0 0 0 0 0 0 0 5 7 0 0 0 0 3 6 0 0 0 0 0 0 5 0 0 0 0 0 0 0 0 0 5 0 0 0 0 0 0 0 0 0 4 4 4 0 0 0 0 0 6 1 1 1 1 1 1 1 1 1 1 1 1 1 1 1 1 1 1 1 1 1 1 1 5 0 0 0 0 0 0 0 0 0 0 0 0 3 6 0 0 0 0 0 0 6 5 7 5 
5 4 4 4 4 4 4 4 0 5 7 0 0 0 0 4 4 4 0 0 0 0 0 5 0 0 0 0 0 0 3 0 0 5 0 0 0 0 0 0 0 0 0 0 0 0 0 0 0 0 0 6 0 0 0 0 0 0 0 0 0 0 0 0 0 0 0 0 0 0 0 0 0 0 0 5 4 0 0 4 4 4 0 0 0 4 0 4 4 4 0 0 6 0 4 4 4 5 7 5 
5 6 0 3 0 0 0 0 0 5 7 0 0 0 0 0 0 0 0 0 3 6 0 5 0 0 0 0 4 4 4 4 0 0 0 0 0 0 0 0 0 0 0 0 0 0 0 0 4 4 4 6 0 0 0 0 0 0 0 0 0 0 0 0 0 0 0 0 0 0 0 0 0 0 0 5 0 0 0 0 0 0 0 0 0 0 0 0 0 0 0 0 4 0 0 0 0 5 7 5 
5 4 4 4 4 4 4 4 0 5 7 0 0 0 0 0 0 0 0 4 4 4 0 5 0 0 0 0 0 0 0 0 0 6 0 0 0 0 0 0 0 0 0 0 3 0 0 0 0 0 0 6 0 0 0 0 0 0 0 0 0 0 0 0 0 0 0 0 0 0 0 0 0 0 0 5 0 0 0 0 0 0 0 4 4 0 0 0 0 0 0 3 0 0 0 0 0 5 7 5 
5 6 0 0 0 3 0 0 0 5 7 0 0 0 0 0 3 6 0 0 0 0 0 5 4 4 4 0 0 0 0 0 0 0 0 0 0 0 0 0 0 0 0 4 4 4 0 0 0 0 0 5 0 0 0 0 0 0 0 0 0 0 0 0 0 0 0 0 0 0 0 0 0 0 0 5 0 4 4 0 0 0 0 0 0 0 0 0 0 0 4 4 4 0 0 0 0 5 7 5 
5 4 4 4 4 4 4 4 0 5 7 0 0 0 0 4 4 4 0 0 0 3 6 5 0 0 0 0 0 3 0 0 0 5 0 6 0 0 0 0 0 0 0 0 0 0 0 0 0 0 0 5 0 0 0 3 0 0 0 0 0 3 0 0 0 0 0 3 0 0 0 0 0 3 6 5 0 0 0 0 0 0 0 3 6 0 0 0 0 0 0 0 0 0 0 0 0 5 7 5 
5 6 0 3 0 0 0 0 0 5 7 0 0 0 0 0 0 0 0 0 4 4 4 5 0 0 0 4 4 4 4 0 0 5 0 0 0 0 0 0 0 0 0 0 0 0 0 0 4 4 4 5 4 4 4 4 4 4 4 4 4 4 4 4 4 4 4 4 4 4 2 2 4 4 4 5 6 0 6 3 0 0 4 4 4 0 0 0 0 0 0 0 0 0 3 6 0 5 7 5 
5 4 4 4 4 4 4 4 0 5 7 0 0 0 0 0 0 0 3 0 3 0 6 5 6 0 0 0 0 0 0 0 0 5 0 0 6 0 0 0 0 0 0 4 4 4 0 0 0 0 0 5 5 5 5 5 5 5 5 5 5 5 5 5 5 5 5 5 5 5 2 2 5 5 5 5 4 0 4 4 4 0 0 0 0 0 0 0 0 0 0 0 0 4 4 4 0 5 7 5 
5 6 0 0 0 0 3 0 0 5 7 0 0 0 0 0 4 4 4 4 4 4 4 5 4 0 0 0 0 0 0 0 0 5 0 0 0 0 0 0 0 0 0 0 0 0 0 3 0 0 0 5 0 0 0 0 0 0 0 0 0 0 0 0 0 0 0 0 0 0 0 0 0 0 0 5 0 0 0 0 0 0 0 0 0 0 0 6 3 0 0 0 0 0 0 0 0 5 7 5 
5 5 5 5 5 5 5 5 0 5 7 0 0 0 0 4 1 1 1 1 1 1 1 5 1 4 4 0 0 3 0 0 0 5 0 0 0 6 0 0 0 0 0 4 4 4 4 4 4 4 7 5 5 5 5 5 5 7 5 5 5 5 5 5 5 5 7 5 5 5 5 5 5 5 5 5 0 0 0 0 0 0 0 0 0 4 4 4 4 4 0 0 0 0 0 0 0 5 7 5 
5 6 0 3 0 0 6 0 0 5 7 0 0 0 4 1 1 1 1 1 1 1 1 5 1 1 1 4 4 4 4 4 7 5 2 2 2 2 2 2 2 2 2 5 1 1 1 1 1 1 7 5 0 0 0 0 0 7 0 5 6 0 0 0 5 0 7 0 5 6 0 0 0 0 0 5 0 0 0 0 6 0 3 0 0 0 0 5 0 0 0 6 3 0 0 0 0 5 7 5 
5 4 4 4 4 4 4 4 0 5 7 0 0 0 1 1 1 1 1 1 1 1 1 5 1 1 1 1 1 1 1 1 7 5 2 2 2 2 2 2 2 2 2 5 1 1 1 1 1 1 7 5 0 0 0 0 0 7 0 5 0 0 0 0 5 0 7 0 5 0 4 0 0 4 4 5 0 0 0 0 4 4 4 4 0 0 0 5 0 0 0 4 4 4 0 0 0 5 7 5 
5 6 0 0 0 3 0 0 0 5 7 0 4 0 1 1 1 1 1 1 1 1 1 5 1 1 1 1 1 1 1 1 7 5 2 2 2 2 2 2 2 2 2 5 1 1 1 1 1 1 7 5 0 0 0 0 0 0 0 5 0 0 4 4 5 0 7 0 5 0 0 0 4 5 5 5 0 0 0 0 0 0 0 0 0 0 5 5 5 0 0 0 0 0 0 0 0 5 7 5 
5 4 4 4 4 4 4 4 0 5 7 4 5 2 5 5 5 5 5 5 5 5 5 5 5 5 5 5 5 5 5 5 2 5 2 5 5 5 5 5 5 5 5 5 5 5 5 5 5 5 7 5 6 0 3 0 0 3 0 5 0 3 0 0 5 0 0 0 5 0 0 0 3 0 0 5 0 0 0 0 0 0 0 0 0 0 5 5 5 0 0 0 0 0 0 0 0 5 7 5 
5 6 0 0 3 0 0 0 0 0 7 5 2 2 2 2 2 2 2 2 2 2 2 2 2 2 2 2 2 2 2 2 2 5 0 0 3 0 3 0 3 0 6 5 6 0 0 3 0 0 7 5 4 4 4 4 4 4 4 5 4 4 4 0 0 0 3 0 0 0 4 4 4 4 4 5 0 0 0 3 0 0 0 0 3 0 0 0 0 3 0 0 0 0 3 0 0 6 7 5 
5 5 5 5 5 5 5 5 5 5 5 5 5 5 5 5 5 5 5 5 5 5 5 5 5 5 5 5 5 5 5 5 5 5 5 5 5 5 5 5 5 5 5 5 5 5 5 5 5 5 5 5 5 5 5 5 5 5 5 5 5 5 5 5 5 5 5 5 5 5 5 5 5 5 5 5 5 5 5 5 5 5 5 5 5 5 5 5 5 5 5 5 5 5 5 5 5 5 5 5 
