19 37
1 1 1 1 1 1 1 1 1 1 1 1 1 1 1 1 1 1 1 1 1 1 1 1 1 1 1 1 1 1 1 1 1 1 1 1 1 
1 0 0 0 0 0 0 0 1 6 0 0 0 0 0 0 0 0 0 0 0 0 0 0 6 1 0 0 0 0 0 0 0 0 0 0 1 
1 0 0 0 0 0 0 0 1 0 0 0 0 0 0 0 0 0 0 0 0 0 0 4 0 1 0 0 0 0 0 0 0 0 0 0 1 
1 0 0 0 0 0 0 0 1 0 4 0 0 0 0 0 0 0 0 0 0 0 4 1 0 1 0 0 0 0 0 0 0 0 0 0 1 
1 0 0 0 0 0 0 0 2 0 0 0 4 0 0 0 0 0 0 0 0 4 1 1 0 1 0 0 0 0 0 0 0 0 0 0 1 
1 0 0 0 0 0 0 0 2 0 0 0 0 0 3 0 0 0 0 4 4 1 1 1 0 1 6 0 0 0 0 4 0 0 0 0 1 
1 0 0 0 0 0 0 0 1 0 0 0 0 4 4 4 0 0 3 1 1 1 1 1 0 1 7 4 0 0 3 1 2 2 2 2 1 
1 0 0 0 0 0 0 0 1 0 0 4 0 0 0 0 4 4 4 1 1 1 1 1 0 1 7 1 4 4 4 1 2 2 2 2 1 
1 0 0 0 0 0 0 0 1 0 3 0 0 0 0 0 3 0 0 0 0 0 0 0 0 1 7 1 1 1 1 1 2 2 2 2 1 
1 0 0 0 0 0 0 0 1 4 4 4 4 2 2 2 4 4 7 4 2 2 2 2 2 5 2 1 1 1 1 6 6 6 6 6 1 
1 0 0 0 0 0 0 0 0 0 0 0 0 0 0 0 0 0 7 1 2 2 2 2 2 5 2 1 6 6 6 6 6 6 6 6 1 
1 0 0 0 0 0 0 6 0 0 0 0 0 0 0 0 0 0 7 1 2 2 2 2 2 5 2 1 6 6 4 6 6 6 6 6 1 
1 0 0 0 0 0 0 0 0 0 3 0 0 0 0 0 0 0 7 1 2 2 2 2 2 5 2 1 6 6 1 6 6 6 6 6 1 
1 4 0 0 0 4 2 2 2 4 4 4 4 4 0 0 0 0 7 1 2 2 2 2 2 2 2 1 6 6 1 4 6 6 6 3 1 
1 1 4 0 3 1 2 2 2 1 6 1 1 1 0 4 0 3 7 1 2 2 2 2 2 2 2 1 6 6 1 1 4 4 4 4 1 
1 1 1 4 4 1 2 2 2 1 2 2 2 2 2 1 4 4 4 1 2 2 2 2 2 5 2 1 6 3 1 1 1 1 1 1 1 
5 5 5 5 5 5 5 5 5 5 5 5 5 5 5 5 5 5 5 5 5 5 5 5 5 5 5 5 5 5 5 5 5 5 5 5 5 
5 5 5 5 5 5 5 5 5 5 5 5 5 5 5 5 5 5 5 5 5 5 5 5 5 5 5 5 5 5 5 5 5 5 5 5 5 
5 5 5 5 5 5 5 5 5 5 5 5 5 5 5 5 5 5 5 5 5 5 5 5 5 5 5 5 5 5 5 5 5 5 5 5 5 
