19 64
5 5 5 5 5 5 5 5 5 5 5 5 5 5 5 5 5 5 5 5 5 5 5 5 5 5 5 5 5 5 5 5 5 5 5 5 5 5 5 5 5 5 5 5 5 5 5 5 5 5 5 5 5 5 5 5 5 5 5 5 5 5 5 5 
5 0 0 0 0 0 0 0 5 5 6 0 0 0 0 0 0 0 3 0 0 0 6 0 3 0 0 0 5 0 4 0 0 0 0 0 0 0 0 0 5 0 0 0 0 0 0 0 0 0 0 0 0 0 0 0 0 0 0 0 0 0 0 5 
5 0 0 0 0 0 0 0 0 5 2 0 0 0 0 0 0 4 4 4 4 0 4 4 4 4 4 0 5 0 0 0 0 0 0 0 0 0 0 0 5 0 0 0 0 0 0 0 0 0 0 0 0 0 0 0 0 0 6 0 0 0 0 5 
5 0 0 0 0 0 0 0 0 5 2 0 0 0 0 0 0 0 0 0 0 0 0 0 1 0 0 0 5 4 0 0 4 4 4 4 4 4 0 0 5 0 0 0 0 0 0 0 0 0 0 0 0 0 0 0 0 0 3 0 0 0 0 5 
5 0 0 0 0 0 0 0 0 5 2 0 4 4 4 4 4 0 0 0 0 0 0 0 1 0 0 0 5 0 0 0 0 1 0 0 0 0 3 0 5 0 0 0 0 0 0 0 0 0 0 0 0 0 0 0 4 4 4 4 0 0 0 5 
5 0 0 0 0 0 0 0 0 5 2 0 0 0 0 0 0 0 3 0 0 3 0 0 1 0 0 0 5 0 4 0 0 1 0 0 0 4 4 4 5 0 0 0 0 0 0 0 0 0 0 0 0 3 0 0 0 0 0 0 0 0 0 5 
5 0 0 0 0 0 0 0 0 5 2 4 4 4 4 4 4 4 4 4 4 4 4 4 1 6 0 0 5 0 0 0 0 1 0 3 0 0 0 0 5 0 0 0 0 0 0 0 0 0 0 0 4 4 4 4 0 0 6 0 0 0 0 5 
5 0 0 0 0 0 0 0 0 5 2 5 5 5 5 5 5 5 5 5 5 5 5 5 5 5 0 7 5 4 0 0 0 1 4 4 4 0 0 0 5 0 0 0 0 0 0 0 0 0 3 0 0 0 0 0 0 0 3 0 0 0 0 5 
5 4 0 0 0 0 0 0 0 5 0 0 0 0 3 0 0 0 0 0 3 0 0 0 3 5 0 7 5 0 0 3 0 1 0 0 0 0 0 0 5 0 0 0 0 0 0 0 0 4 4 4 0 0 0 0 4 4 4 4 0 0 0 5 
5 1 4 0 0 0 0 0 0 5 5 5 5 5 5 5 5 5 5 5 5 5 7 5 5 5 0 7 5 0 4 4 4 1 4 4 0 0 3 0 5 0 0 0 3 0 0 0 0 0 0 0 0 0 3 0 0 0 0 0 0 0 0 5 
5 1 1 4 0 0 0 0 0 0 0 0 0 0 0 0 0 0 0 0 0 0 7 5 5 5 0 7 5 0 5 5 5 5 5 5 0 4 4 4 5 7 4 4 4 4 4 4 4 4 4 4 4 4 4 4 4 4 4 4 4 0 0 5 
5 1 1 1 4 0 0 0 0 0 0 0 0 0 0 0 0 0 0 0 0 0 7 5 5 5 2 2 5 2 5 0 0 0 0 5 0 0 0 0 5 7 5 5 5 5 5 5 5 0 0 0 0 0 0 0 0 0 0 0 5 0 0 5 
5 1 1 1 1 4 0 0 0 0 0 0 0 0 0 0 0 0 0 0 0 0 7 5 5 5 2 2 5 2 5 0 7 5 2 5 0 0 0 0 5 7 5 6 0 3 0 0 5 7 5 5 5 5 5 5 5 5 5 0 5 0 0 5 
5 1 1 1 1 1 4 4 0 0 0 0 0 0 0 0 0 0 0 0 0 0 7 5 5 5 2 2 5 2 5 0 7 5 2 5 2 2 2 2 5 2 5 5 5 5 5 2 5 7 5 0 0 0 3 0 0 6 5 0 5 0 0 5 
5 1 1 1 1 1 1 1 4 0 3 0 0 0 0 0 0 0 0 0 0 0 7 5 5 5 2 2 5 2 5 0 0 5 2 5 2 2 2 2 2 2 5 2 2 2 2 2 5 2 5 2 5 5 5 5 5 5 5 2 5 2 2 5 
5 1 1 1 1 1 1 1 1 4 4 4 4 0 3 0 0 0 3 0 0 0 7 5 5 5 2 2 2 2 5 0 6 5 2 5 2 2 2 2 2 2 5 2 5 5 5 2 5 2 5 2 2 2 2 2 2 2 2 2 5 2 2 5 
5 1 1 1 1 1 1 1 1 1 1 1 1 4 4 2 2 4 4 4 4 4 4 5 5 5 2 2 2 2 5 5 5 5 2 5 2 2 2 2 5 2 5 2 5 5 5 2 5 2 5 5 5 5 5 5 5 5 5 5 5 2 2 5 
5 1 1 1 1 1 1 1 1 1 1 1 1 1 1 1 2 2 2 2 2 6 1 5 5 5 2 2 5 2 2 2 2 2 2 5 2 2 2 2 5 2 2 2 2 2 2 2 5 2 2 2 2 2 2 2 2 2 2 2 2 2 2 5 
5 5 5 5 5 5 5 5 5 5 5 5 5 5 5 5 5 5 5 5 5 5 5 5 5 5 5 5 5 5 5 5 5 5 5 5 5 5 5 5 5 5 5 5 5 5 5 5 5 5 5 5 5 5 5 5 5 5 5 5 5 5 5 5 